0 0 0 0 0
0 E W 0 0
0 E 0 1 0
0 0 W 2 0
0 0 0 0 S
