0 0 0 0 0 0
0 E W 0 0 0
0 0 0 1 0 0
0 0 W 0 0 0
0 0 0 0 S 0
0 0 0 0 0 0
