0 0 0 E 0 0 0
0 0 W 0 0 0 0
0 0 0 0 0 W 0
0 0 0 0 2 0 0
0 W 0 0 0 2 0
0 0 0 0 W 0 0
0 0 E 0 0 0 S
