0 0 0 0 0
0 E W 0 0
0 E 0 1 0
0 0 W 1 0
0 0 0 0 S
