0 0 0 0 0 0
0 0 E 0 0 0
0 0 E 1 0 0
0 0 2 0 0 0
0 0 0 0 S 0
0 0 0 0 0 0
